15
..o.oooo..o....
.o.o.....ooo..o
..o...o..oooooo
...o......oo.oo
o.ooo.o..o.oo..
o..o.oooo.oo..o
o.o...oo.o.o..o
..o.......o...o
o.o.o.oo.o....o
...o.o...o.o...
..ooo.oo...o.oo
.o.o..o.....o.o
.oo.o...o.o...o
oooo.oo..oo.o..
...o.o.o.o.oo.o
